Rd, Rd, Rd, Hhd, Hhd, Hhd, Hhd, Hhd, Hhd, Hhd, Hhd, Hhd, Hhd, Hhd, Dd, Dd, Dd, Dd, Dd, Dd, Dd, Dd, Dd, Dd, Dd, Dd, Dd, Dd
Rd, Rd, Rd, Hhd, Hhd, Hhd, Hhd, Hhd, Hhd, Hhd, Hhd, Hhd, Hhd, Hhd, Dd, Dd, Dd, Dd^Edp, Dd, Dd, Dd, Dd, Dd, Dd, Dd, Dd^Edp, Dd, Dd
Hhd, Hhd, Hhd, Rd, Hhd, Hhd, Hhd, Hhd, Ds^Edp, Ds, Hhd, Hhd, Hhd, Dd, Dd, Dd, Dd, Dd, Dd, Dd^Es, Dd, Dd^Edp, Dd, Dd, Dd, Dd, Dd, Dd
Hhd, Hhd, Hhd, Rd, Hhd, Hhd, Hhd, Hhd, Hhd, Hhd, Hhd, Hhd, Dd, Dd, Dd, Dd, Hd, Hd, Hd, Dd, Dd, Dd, Dd^Es, Dd, Hd, Dd, Dd, Dd
Hhd, Hhd, Hhd, Rd, Rd, Hhd, Hhd, Hhd, Hhd, Hhd, Hhd, Hhd, Dd, Dd^Edp, Dd, Dd, Hd, Hd, Dd, Dd, Dd, Dd, Dd, Hd, Hd, Dd, Dd, Dd
Hhd, Hhd, Hhd, Hhd, Hhd, Rd, Ds, Hhd, Hhd, Hhd, Dd, Dd, Dd, Dd, Dd, Dd, Dd, Hd, Dd, Dd, Dd, Dd, Cyd, Hd, Dd, Dd^Es, Dd, Dd
Hhd, Hhd, Hhd, Ds^Edp, Rd, Rd, Hhd, Hhd, Hhd, Hhd, Dd, Dd, Hd, Dd, Hd, Dd, Dd, Dd, Dd, Dd, Dd, Dd^Es, Cyd, 4 Kyd, Cyd, Dd, Dd, Dd
Hhd, Hhd, Hhd, Ds, Rd, Hhd, Hhd, Hhd, Hhd, Hhd, Dd, Hd, Hd, Hd, Hd, Dd, Dd, Dd, Dd^Edp, Dd, Dd^Es, Dd, Cyd, Cyd, Dd, Dd, Dd, Dd
Hhd, Hhd, Hhd, Hhd, Hhd, Rd, Rd, Rd, Dd, Dd, Dd, Dd, Hd, Hd, Hd, Hd, Dd, Dd, Dd, Dd, Dd, Dd, Dd, Hd, Hd, Dd^Es, Dd, Dd
Hhd, Hhd, Hhd, Hhd, Hhd, Hhd, Rd, Rd, Dd, Dd, Dd, Hd, Hd, Hd, Hd, Hd, Dd, Dd, Dd, Dd, Dd, Dd, Dd, Hd, Dd, Dd, Dd, Dd
Hhd, Hhd, Ds, Hhd, Hhd, Hhd, Dd, Dd, Dd, Dd, Dd, Dd, Dd, Dd, Dd^Ecf, Hd, Dd^Vdt, Dd, Dd, Dd, Dd, Dd, Dd, Dd, Dd, Dd^Edp, Dd, Dd
Hhd, Hhd, Hhd, Hhd, Hhd, Hhd, Dd, Dd^Edp, Dd, Dd, Dd, Dd, Hd, Hd, Hd, Hd, Dd, Dd, Dd, Dd, Dd, Dd, Dd, Dd, Hd, Dd, Dd, Dd
Hhd, Hhd, Hhd, Hhd, Dd^Edp, Dd, Hd, Dd, Dd, Dd, Dd, Dd^Vdt, Hd, Hd, Dd, Dd, Dd, Dd, Dd, Dd^Vdt, Dd, Dd, Dd, Dd, Hd, Dd, Dd, Dd
Hhd, Hhd, Hhd, Dd, Dd, Hd, Hd, Hd, Dd, Dd, Dd, Hd, Dd, Dd, Dd, Dd^Vdt, Dd, Dd, Dd, Dd, Hd, Hd, Dd, Dd, Hd, Hd, Hd, Hd
Hhd, Hhd, Dd^Edp, Dd, Dd^Edp, Dd, Dd, Hd, Dd, Dd, Dd, Dd, Dd, Dd, Dd, Dd, Dd, Dd, Dd, Dd, Hd, Dd^Vdt, Dd, Dd, Hd, Hd, Hd, Hd
Hhd, Hhd, Dd, Hd, Dd, Dd, Ce, Dd, Dd, Dd, Wwt, Dd^Edp, Dd, Dd, Dd, Dd, Dd^Ecf, Dd, Dd, Dd, Dd, Dd, Dd, Dd, Dd, Hd, Hd, Hd
Dd, Dd, Dd, Dd, Dd, Ce, 1 Ke, Ce, Dd, Wwt, Wwt, Wwt, Dd, Dd^Vdt, Dd, Dd, Dd, Dd, Dd^Vdt, Dd, Dd, Dd, Dd, Dd, Dd, Hd, Hd, Hd
Dd, Dd, Hd, Dd, Dd, Ce, 2 Ce, Ce, Dd, Dd^Edp, Wwt, Wwt, Dd^Edp, Dd, Dd, Dd, Dd, Dd, Dd, Dd, Dd, Dd, Dd, Dd, Dd, Dd, Dd, Dd
Dd, Dd, Dd, Dd, Dd, Dd, Dd, Dd^Es, Dd, Dd, Dd^Edp, Wwt, Dd, Dd, Dd^Vdt, Dd, Dd, Dd, Dd, Dd^Vdt, Dd, Dd, Hd, Dd, Dd, Dd^Edp, Dd, Dd
Dd, Dd, Dd, Dd, Dd, Dd, Dd, Dd, Dd, Dd, Dd^Vdt, Dd, Dd, Dd, Dd, Dd, Dd, Dd, Dd, Dd, Hd, Hd, Hd, Dd, Dd, Dd, Dd, Dd
Dd^Edp, Dd, Hd, Dd, Dd, Dd, Dd, Dd, Dd, Dd, Dd, Dd, Dd, Dd^Ecf, Dd, Dd, Dd, Dd^Vdt, Dd, Dd, Dd, Hd, Dd, Dd, Dd, Dd, Dd^Edp, Dd
Dd, Dd, Dd, Dd, Dd, Dd, Dd, Dd, Dd, Dd, Hd, Dd, Hd, Hd, Hd, Dd, Dd, Dd, Dd, Dd, Dd, Dd^Es, Dd, Dd, Dd, Dd, Dd, Dd
Dd, Dd^Edp, Dd, Dd, Dd, Dd^Edp, Dd, Dd, Dd, Dd, Hd, Hd, Hd, Dd^Vdt, Hd, Dd, Dd, Dd, Dd^Es, Dd, Cyd, Dd, Dd, Dd^Es, Dd^Edp, Dd, Dd, Dd
Dd, Dd, Dd^Edp, Dd, Dd, Dd, Dd, Dd, Dd, Dd, Dd, Hd, Hd, Hd, Dd, Dd, Hd, Hd, Dd, Dd, Cyd, Cyd, Cyd, Dd, Dd, Dd, Dd, Dd
Hd, Hd, Hd, Dd, Dd, Dd, Dd, Dd, Dd, Dd, Dd, Hd, Dd, Hd, Dd, Dd, Dd, Hd, Dd, Dd, Cyd, 3 Kyd, Dd, Dd, Hd, Hd, Dd, Dd
Hd, Hd, Hd, Hd, Hd, Dd, Dd, Dd^Edp, Dd, Dd, Dd, Dd, Dd, Dd, Dd, Dd, Dd, Dd, Dd, Dd^Es, Dd, Dd, Dd, Dd, Dd, Hd, Dd, Dd
Hd, Hd, Hd, Hd, Hd, Dd, Dd, Dd, Dd, Dd, Dd, Dd, Dd, Dd^Edp, Dd, Dd, Dd, Dd, Dd, Dd, Dd^Edp, Dd, Dd, Dd, Dd, Dd, Dd, Dd
Hd, Hd, Hd, Hd, Hd, Dd, Dd, Dd, Dd, Dd, Dd, Dd, Dd, Dd, Dd, Dd, Dd, Dd, Dd, Dd, Dd, Dd, Dd, Dd, Dd, Dd, Dd, Dd
