Xu, Xu, Xu, Xu, Xu, Xu, Xu, Uu, Xu, Xu, Xu, Xu, Xu, Xu, Xu, Xu, Xu, Xu, Xu, Xu, Xu, Xu, Xu, Uu, Xu, Xu, Xu, Xu, Xu, Xu, Xu, Xu, Xu, Xu, Xu, Xu, Xu, Xu, Xu, Xu, Xu, Xu
Xu, Xu, Xu, Wo, Xu, Xu, Xu, Uu, Xu, Xu, Xu, Xu, Xu, Xu, Xu, Xu, Xu, Xu, Xu, Xu, Xu, Xu, Xu, Uu, Xu, Xu, Xu, Xu, Xu, Xu, Xu, Xu, Xu, Xu, Xu, Xu, Xu, Xu, Xu, Xu, Xu, Xu
Xu, Xu, Xu, Wo, Xu, Xu, Xu, Uu, Uh, Xu, Xu, Xu, Xu, Xu, Xu, Xu, Xu, Xu, Xu, Xu, Xu, Xu, Xu, Uu, Uu, Xu, Xu, Xu, Xu, Xu, Xu, Xu, Xu, Xu, Xu, Xu, Xu, Xu, Xu, Xu, Xu, Xu
Xu, Xu, Xu, Wo, Xu, Xu, Xu, Xu, Uh, Xu, Xu, Xu, Xu, Xu, Xu, Xu, Xu, Xu, Xu, Xu, Xu, Xu, Xu, Xu, Xu, Uu, Xu, Xu, Xu, Xu, Xu, Xu, Xu, Xu, Xu, Xu, Xu, Xu, Xu, Xu, Xu, Xu
Xu, Xu, Xu, Wo, Xu, Xu, Xu, Xu, Xu, Uh, Uu, Xu, Xu, Xu, Uu, Xu, Xu, Xu, Xu, Xu, Xu, Xu, Xu, Xu, Uu, Uu, Wwg, Wwg, Wwg, Xu, Xu, Xu, Xu, Xu, Xu, Xu, Xu, Xu, Xu, Xu, Xu, Xu
Xu, Xu, Wo, Wo, Xu, Xu, Xu, Xu, Xu, Xu, Uu, Xu, Xu, Uh, Xu, Xu, Xu, Xu, Uu, Uh, Uu, Uh, Uu, Xu, Wwg, Wwg^Bs|, Uu, Xu, Xu, Wwg, Wwg, Xu, Xu, Xu, Xu, Xu, Ql, Xu, Xu, Xu, Xu, Xu
Xu, Xu, Wo, Xu, Xu, Xu, Xu, Xu, Uu, Uu, Ce, Uu, Uh, Uh, Uh, Xu, Uu, Uu, Re, Uu, Xu, Uu, Wwg^Bs\, Wwg, Xu, Re, Re, Uu^Vu, Uh, Xu, Xu, Wwg, Wwg, Xu, Uu, Uu, Uu, Xu, Xu, Xu, Xu, Xu
Xu, Xu, Wo, Xu, Xu, Xu, Uu, Uu, Ce, Ce, 4 Ke, Ce, Uu, Uh, Re, Uu, Re, Re, Xu, Xu, Wwg, Wwg, Xu, Uu, Re, Xu, Uu, Uu, Ce, Uh, Xu, Xu, Uu, Wwg, Wwg, Uu, Uu, Xu, Xu, Xu, Xu, Xu
Xu, Xu, Wo, Xu, Xu, Xu, Uh, Uu, Re, Ce, Ce, Uu, Uu^Vud, Uu, Xu, Re, Xu, Xu, Wwg, Wwg, Xu, Xu, Xu, Xu, Re, Uu, Ce, Ce, Ce, Uh, Uu^Vu, Xu, Xu, Uh, Uh, Wwg, Wwg, Xu, Xu, Xu, Xu, Xu
Xu, Xu, Wo, Xu, Xu, Xu, Uh, Uu^Vud, Uu, Re, Uu, Uu, Re, Uu, Xu, Xu, Xu, Xu, Wwg, Xu, Xu, Xu, Xu, Xu, Xu, Uu, Ce, 5 Ke, Ce, Uu, Uu, Xu, Xu, Xu, Xu, Xu, Xu, Wwg, Wwg, Xu, Xu, Xu
Xu, Xu, Xu, Wwg, Xu, Xu, Xu, Uh, Xu, Uu, Uu, Re, Xu, Xu, Xu, Xu, Wwg, Wwg, Uu, Xu, Xu, Xu, Xu, Xu, Xu, Uu, Uu, Ce, Uu, Re, Re, Uu, Uu^Vu, Xu, Xu, Xu, Xu, Xu, Wwg, Xu, Xu, Xu
Xu, Xu, Xu, Wwg, Xu, Xu, Xu, Xu, Re, Uu, Uu, Uu, Xu, Xu, Xu, Wwg, Xu, Xu, Uu, Xu, Xu, Xu, Xu, Uu^Vu, Uu, Uu, Uu^Vu, Uu, Xu, Xu, Uu, Uu, Uh, Xu, Xu, Xu, Xu, Xu, Wwg, Xu, Xu, Xu
Xu, Xu, Xu, Wwg, Xu, Xu, Re, Re, Re, Uu, Uh, Uh, Xu, Xu, Wwg, Wwg, Xu, Xu, Uu^Em, Xu, Xu, Xu, Xu, Xu, Xu, Re, Re, Re, Xu, Xu, Uu, Uu, Uu, Uh, Xu, Xu, Xu, Xu, Wwg, Xu, Xu, Xu
Xu, Xu, Xu, Wwg, Wwg, Xu, Uu, Uu, Uu, Xu, Xu, Xu, Wwg, Wwg, Xu, Xu, Xu, Rb, Uu^Em, Uu, Tb^Tf, Xu, Xu, Xu, Xu, Xu, Xu, Xu, Xu, Uu^Vu, Uu, Uu, Rr, Rr, Xu, Xu, Xu, Xu, Wwg, Xu, Xu, Xu
Xu, Xu, Xu, Xu, Xu, Wwg, Wwg, Wwg^Bs|, Wwg, Wwg, Wwg, Wwg, Xu, Xu, Xu, Xu, Xu, Uu^Em, Wwg, Uu, Tb^Tf, Xu, Xu, Xu, Xu, Xu, Xu, Xu, Xu, Xu, Xu, Uu, Uu, Xu, Xu, Xu, Xu, Xu, Wwg, Xu, Xu, Xu
Xu, Xu, Uu^Vud, Xu, Xu, Uu, Rb, Rb, Uu, Xu, Xu, Xu, Xu, Xu, Uh, Xu, Uh, Uu, Uu, Tb^Tf, Xu, Xu, Xu, Xu, Xu, Xu, Xu, Xu, Xu, Xu, Xu, Uu, Rr, Xu, Xu, Xu, Xu, Xu, Ww, Xu, Xu, Xu
Xu, Xu, Xu, Uu, Uu, Uu^Em, Uu, Uh, Uh, Uu^Vud, Xu, Xu, Wwg, Uu, Xu, Uh, Xu, Xu, Xu, Xu, Xu, Xu, Xu, Xu, Xu, Xu, Hh, Hh, Hh, Hh, Hh, Hh, Rr, Hh, Hh, Mm, Mm, Mm, Ww, Mm, Mm, Mm
Xu, Xu, Xu, Xu, Rb, Uu, Uu^Vud, Uu, Uh, Uh, Xu, Xu, Xu, Xu, Xu, Xu, Xu, Xu, Xu, Xu, Xu, Xu, Xu, Xu, Xu, Xu, Hh, Hh, Hh, Hh, Hh, Hh, Hh, Rr, Hh, Hh, Hh, Mm, Ww, Mm, Mm, Mm
Xu, Xu, Xu, Xu, Xu, Rb, Uu, Uu, Uh, Xu, Xu, Xu, Xu, Xu, Xu, Xu, Xu, Xu, Xu, Xu, Xu, Xu, Hh, Hh, Hh, Hh, Hh, Hh, Hh, Hh, Hh^Vc, Hh, Rr, Rr, Hh, Hh, Ww, Ww, Mm, Mm, Mm, Mm
Xu, Xu, Xu, Xu, Uu^Vud, Uu, Rb, Uu, Uu, Xu, Xu, Xu, Xu, Xu, Xu, Xu, Xu, Xu, Mm, Mm, Mm, Mm, Hh, Hh, Hh, Hh, Hh, Hh, Ss, Hh, Hh, Hh, Rr, Hh, Ww, Ww, Ww, Hh, Hh, Mm, Mm, Mm
Xu, Xu, Xu, Xu, Uu, Xu, Xu, Uu, Uu, Xu, Xu, Xu, Xu, Xu, Xu, Xu, Mm, Mm, Mm, Mm, Mm, Mm, Hh, Hh, Hh, Hh, Ss, Ss, Ww, Ww, Ww, Hh, Ww^Bw|, Ww, Hh, Hh, Ww, Hh, Hh, Mm, Mm, Mm
Xu, Xu, Xu, Xu, Xu, Xu, Uh, Rb, Uu, Xu, Xu, Xu, Xu, Xu, Mm, Mm, Mm, Mm, Mm, Mm, Mm, Hh, Hh, Hh, Ww, Ww, Ss, Ss, Ss, Ss, Ss, Ww, Rr, Gs^Vc, Hh, Hh, Ww, Hh, Hh, Hh, Hh, Hh
Xu, Xu, Xu, Xu, Xu, Xu, Uh^Em, Uh, Uu, Xu, Xu, Xu, Mm, Mm, Mm, Mm, Mm, Mm, Mm, Mm, Mm, Hh, Hh, Hh, Ww, Hh, Hh, Ss, Hh, Ss, Hh, Gs^Vc, Rr, Hh, Hh, Ss, Ss, Hh, Hh, Hh, Hhd, Hhd
Xu, Xu, Xu, Xu, Xu, Xu, Xu, Uh, Uu, Rr, Xu, Hh, Hh, Mm, Hh, Mm, Hh, Hh, Hh, Mm, Hh, Hh, Hh, Ww, Gs^Vc, Hh, Hh, Hh, Ce, Hh, Hh, Hh, Rr, Hh, Hh, Ss, Ss, Hh, Hh, Hhd, Hhd, Hhd
Xu, Xu, Xu, Xu, Xu, Xu, Xu, Xu, Xu, Rr, Rr, Hh, Hh, Hh, Hh, Hh, Hh, Hh, Hh^Vc, Hh, Hh, Hh, Hh, Ww, Re, Hh, Re, Ce, 3 Ke, Ce, Rr, Hh, Rr, Hh, Hh, Ss, Ww, Ss, Hh, Hhd, Hhd, Hhd
Xu, Xu, Xu, Xu, Xu, Xu, Xu, Xu, Xu, Xu, Hhd, Rr, Rr, Hh, Rr, Hh, Hh, Hh, Hh, Hh, Rr, Rr, Rr, Ww^Bw/, Gs^Vc, Re, Hh, Ce, Ce, Ce, Hh, Rr, Rr, Hh, Hh, Ss, Ww, Ss, Hh, Hhd, Hhd, Hhd
Xu, Xu, Xu, Xu, Xu, Xu, Xu, Xu, Xu, Xu, Hhd, Hhd, Hhd, Rr, Hhd, Rr, Hh, Hh, Rr, Rr, Hh, Hh, Hh, Ww, Hh, Hh, Hh, Hh, Hh, Hh, Hh, Hh, Rr, Gs^Vc, Ww, Ww, Ss, Ss, Hh, Hhd, Hhd, Hhd
Xu, Xu, Xu, Xu, Xu, Xu, Xu, Xu, Xu, Hhd, Hhd, Hhd, Hhd, Hhd, Hhd, Rr, Rr, Rr, Hh, Hh, Hh, Hh, Hh, Ww, Ss, Hh, Ss, Ss, Ww, Hh, Ww, Gs^Vc, Ww^Bw|, Ww, Ss, Ss, Hh, Hh, Hhd^Vc, Hhd, Hhd, Hhd
Xu, Xu, Xu, Xu, Xu, Xu, Xu, Xu, Xu, Hhd, Hhd, Hhd, Hhd, Hhd, Hhd, Hhd, Rr, Hh, Hh, Hh, Hh, Hh^Vc, Hh, Hh, Ss, Ss, Ss, Ss, Ss, Ww, Ss, Ww, Rd, Hh, Hh, Hh, Hh, Hh, Mm, Hhd, Hh, Hhd
Xu, Xu, Xu, Xu, Xu, Xu, Xu, Xu, Hhd, Hhd, Hhd, Hhd, Hhd, Hhd, Hhd, Hhd, Hhd, Rr, Rr, Hh, Hh, Hh, Hh, Hh, Ww, Ss, Hh, Ss, Hh^Vc, Ss, Hh, Hhd, Rd, Hhd, Hhd, Hh, Hh, Mm, Mm, Hh, Hhd, Hh
Xu, Xu, Xu, Xu, Xu, Xu, Xu, Hhd, Hhd, Hhd, Hhd, Hhd, Hhd, Hhd, Hhd, Hhd, Hhd, Hhd, Rr, Hh, Hh, Hh, Ww, Ww, Hh, Hh, Hh, Hh, Hh, Hh, Hhd, Hhd, Hhd, Rd, Rd, Hhd, Hhd, Hh, Hhd, Hhd, Hhd, Hhd
Xu, Xu, Xu, Xu, Xu, Xu, Xu, Hhd, Hhd, Hhd, Hhd, Hhd, Hhd, Hhd, Hhd, Hhd, Hh, Hhd, Rr, Hh, Gs^Vc, Ww, Hh, Hh, Hh, Hh, Mm, Mm, Mm, Hhd, Hhd, Hhd^Vc, Hhd, Hhd, Rd, Hhd, Hhd, Hhd, Hhd^Vc, Hhd, Hhd, Hhd
Xu, Xu, Xu, Xu, Xu, Xu, Hhd, Hhd, Hhd, Hh, Mm, Hhd, Hhd, Hhd, Hh, Hh, Hh, Ss, Ss^Vhs, Rr, Ww^Bw\, Ww, Hhd, Hhd, Hhd, Hh, Hh, Mm, Hhd, Hhd, Hhd, Hhd, Hhd, Hhd, Rd, Hhd, Hhd, Hhd, Hhd, Hhd, Hhd, Hhd
Xu, Xu, Xu, Xu, Xu, Hhd, Hhd, Hh, Mm, Mm, Mm, Hh, Hh, Hh, Ss, Ss, Ss, Ss, Ss, Ss, Rd, Rd, Hhd, Hhd, Hhd, Hhd, Hhd, Hhd, Hhd, Hhd^Vc, Hhd, Hhd, Rd, Rd, Hhd, Hhd, Hhd, Hhd, Hhd, Hhd, Hhd, Hhd
Xu, Xu, Xu, Xu, Xu, Hhd, Hh, Mm, Mm, Mm, Hh, Hh, Hh, Ww, Ww, Ww, Ww, Ss, Ww, Ss, Ss, Rd, Hhd, Hhd, Hhd, Hhd, Hhd, Hhd, Hhd, Hhd, Hhd, Hhd, Rd, Hhd, Hhd, Hhd, Hhd, Hhd, Hhd, Hd, Hd, Hd
Xu, Xu, Xu, Xu, Hhd, Hhd, Mm, Mm, Mm, Mm, Hh, Hh, Ww, Ww, Wo, Wo, Wo, Ww, Wo, Ww, Ww, Rd, Rd, Hhd, Hhd, Hhd, Hhd, Hhd, Rd, Rd, Rd, Rd, Hhd, Rd, Hhd, Hhd, Hd, Hhd, Hd, Hd, Dd, Dd
Xu, Xu, Xu, Xu, Hhd, Hhd, Mm, Mm, Mm, Mm, Hh, Hh, Ww, Wo, Wo, Wo, Wo, Wo, Wo, Ww, Hh, Hhd, Hhd, Rd, Rd, Rd, Rd, Rd, Hhd, Hhd, Hhd, Hhd, Hhd, Rd, Rd, Hd^Edp, Dd, Hd, Dd, Dd, Dd, Dd
Xu, Xu, Xu, Xu, Hhd, Hh, Mm, Mm, Mm, Mm, Hh, Hh, Hh, Ww, Ww, Wo, Wo, Wo, Ww, Ww, Hh, Hh, Hh, Hhd, Hhd, Hhd, Hhd, Hhd, Hhd^Vc, Hhd, Hhd, Hd, Hd^Edp, Dd^Es, Dd, Dd^Es, Ce, Dd, Dd, Dd, Dd, Dd
Xu, Xu, Xu, Hhd, Hhd, Hhd, Hh, Mm, Hh, Hh, Hhd, Hhd, Hh, Hh, Hh, Ww, Ww, Ww, Hh, Hh, Hh, Mm, Mm, Hhd, Hhd, Hhd, Hhd, Hhd, Hhd, Hhd, Hd, Hd, Dd, Dd, Dd, Ce, 1 Ke, 2 Ce, Dd, Dd^Vdt, Dd, Dd
Xu, Xu, Xu, Hhd, Hhd, Hhd, Hhd, Hhd, Hhd, Hhd, Hhd, Hhd, Hhd, Hhd, Hh, Ww, Hh, Hh, Hh, Hh, Hhd, Mm, Mm, Mm, Hh, Hhd, Hd, Hhd, Hd, Hd, Hd, Hd, Dd, Dd^Vdt, Dd, Ce, Ce, Ce, Dd, Dd, Dd, Dd
Xu, Xu, Xu, Hhd, Hhd, Hhd, Hhd, Hhd, Hhd, Hhd, Hhd, Hhd, Hhd, Hhd, Hhd, Hh, Hhd, Hhd, Hhd, Hhd, Hhd, Hh, Hhd, Hh, Hhd, Hhd, Hd, Hd, Dd, Dd, Dd, Dd, Dd, Dd, Dd, Dd, Dd, Dd, Dd, Dd^Edp, Dd, Dd
Xu, Xu, Xu, Hhd, Hhd, Hhd, Hhd, Hhd, Hhd, Hhd, Hhd, Hhd, Hhd, Hhd, Hhd, Hhd, Hhd, Hhd, Hhd, Hhd, Hhd, Hhd, Hhd, Hhd, Hhd, Hhd, Hd, Hd, Dd, Dd, Dd, Dd, Dd, Dd, Dd, Dd, Dd, Dd, Dd, Dd, Dd, Dd
