Xu, Xu, Xu, Xu, Xu, Xu, Xu, Xu, Xu, Xu, Xu, Xu, Xu, Xu, Xu, Xu, Xu, Xu, Xu, Xu, Xu, Xu, Xu, Xu, Xu, Xu, Uu, Uu, Xu, Xu, Xu, Xu, Xu, Xu, Xu, Xu, Wo, Xu, Xu, Xu, Xu, Xu, Xu, Xu, Xu, Xu, Xu, Xu, Xu, Xu, Xu, Xu
Xu, Xu, Xu, Xu, Xu, Xu, Xu, Xu, Xu, Xu, Xu, Xu, Xu, Xu, Xu, Xu, Xu, Xu, Xu, Xu, Xu, Xu, Xu, Xu, Xu, Xu, Uu, Uu, Xu, Xu, Xu, Xu, Xu, Xu, Xu, Xu, Wo, Xu, Xu, Xu, Xu, Xu, Xu, Xu, Xu, Xu, Xu, Xu, Xu, Xu, Xu, Xu
Xu, Xu, Xu, Xu, Xu, Xu, Xu, Xu, Xu, Xu, Xu, Xu, Xu, Xu, Xu, Xu, Xu, Xu, Xu, Xu, Xu, Xu, Xu, Xu, Uu, Uu, Xu, Xu, Xu, Xu, Xu, Xu, Xu, Xu, Xu, Wo, Xu, Xu, Xu, Xu, Xu, Xu, Xu, Xu, Xu, Xu, Xu, Xu, Xu, Xu, Xu, Xu
Xu, Xu, Xu, Xu, Xu, Xu, Xu, Xu, Uu, Uh, Uu, Xu, Uh, Xu, Xu, Xu, Xu, Xu, Xu, Xu, Xu, Xu, Xu, Uu, Xu, Xu, Xu, Xu, Xu, Xu, Xu, Xu, Wwg, Xu, Wwg, Wwg, Xu, Xu, Xu, Xu, Xu, Xu, Xu, Xu, Xu, Xu, Xu, Xu, Xu, Xu, Xu, Xu
Uu, Uu, Uu, Xu, Uu, Uu, Xu, Xu, Uh, Uh, 2 Ce, Uu, Uu, Uu, Xu, Xu, Xu, Xu, Xu, Xu, Tb^Tf, Xu, Uu, Uu, Uu, Xu, Xu, Xu, Xu, Xu, Re, Tb^Tf, Wwg, Wwg, Wwg, Xu, Xu, Xu, Xu, Uu, Uu, Uu, Xu, Xu, Xu, Xu, Xu, Xu, Xu, Xu, Xu, Xu
Xu, Uu, Xu, Uu, Uu, Uu, Uu, Uu, Uu, Ce, 1 Ke, Ce, Uu, Xu, Uu, Xu, Xu, Xu, Xu, Tb^Tf, Xu, Uu^Vu, Uu, Uu, Xu, Xu, Xu, Xu, Xu, Re, Uu, Tb^Tf, Uu^Em, Wwg, Uu, Xu, Xu, Uu, Uu, Uu, Uu, Xu, Xu, Xu, Xu, Xu, Xu, Xu, Xu, Xu, Xu, Xu
Xu, Xu, Xu, Xu, Uh, Uu, Uh, Uu, Uu, Uu, Uu, Ce, Uu, Uu, Re, Xu, Xu, Xu, Re, Tb^Tf, Uu, Uu, Xu, Uu^Vu, Uu, Re, Re, Xu, Uu, Uh, Uu, Uu, Re, Uu, Uu^Em, Xu, Uu, Uu, Uu, Xu, Xu, Xu, Xu, Xu, Xu, Xu, Xu, Xu, Xu, Xu, Xu, Xu
Xu, Xu, Xu, Xu, Xu, Uh, Xu, Uh, Uu, Uh, Uh, Uu, Xu, Uu, Xu, Re, Xu, Re, Uu^Em, Uu, Uu, Uu, Uu, Uu, Uu, Re, Re, Re, Uu, Uu, Re, Re, Re, Uu, Uu, Uu, Xu, Xu, Xu, Xu, Xu, Xu, Xu, Xu, Xu, Xu, Xu, Xu, Xu, Xu, Xu, Xu
Xu, Xu, Xu, Xu, Xu, Xu, Xu, Xu, Xu, Xu, Xu, Uu, Xu, Xu, Xu, Xu, Xu, Uu, Uu, Uu, Uu, Xu, Cud, Cud, Xu, Xu, Xu, Re, Xu, Uu, Uh, Re, Uu, Xu, Xu, Xu, Xu, Xu, Xu, Xu, Xu, Xu, Xu, Xu, Xu, Xu, Xu, Xu, Xu, Xu, Xu, Xu
Xu, Xu, Xu, Xu, Xu, Xu, Xu, Xu, Xu, Xu, Xu, Xu, Xu, Xu, Xu, Xu, Xu, Xu, Uh, Uh, Uh, Cud, Xu, Kud, Uu, Xu, Xu, Xu, Xu, Xu, Xu, Xu, Xu, Xu, Xu, Xu, Xu, Xu, Xu, Xu, Xu, Xu, Xu, Xu, Xu, Xu, Xu, Xu, Xu, Xu, Xu, Xu
Xu, Xu, Xu, Xu, Xu, Xu, Xu, Xu, Xu, Xu, Xu, Xu, Xu, Xu, Xu, Xu, Xu, Xu, Xu, Xu, Xu, Uh, Xu, Uu, Uu, Xu, Xu, Xu, Xu, Xu, Xu, Xu, Xu, Xu, Xu, Xu, Xu, Xu, Xu, Xu, Xu, Xu, Xu, Xu, Xu, Xu, Xu, Xu, Xu, Xu, Xu, Xu
Xu, Xu, Xu, Xu, Xu, Xu, Xu, Xu, Xu, Xu, Xu, Xu, Xu, Xu, Xu, Xu, Xu, Xu, Xu, Xu, Xu, Xu, Xu, Uu, Uu, Xu, Xu, Xu, Xu, Xu, Xu, Xu, Xu, Xu, Xu, Xu, Xu, Xu, Xu, Xu, Xu, Xu, Xu, Xu, Xu, Xu, Xu, Xu, Xu, Xu, Xu, Xu
Xu, Xu, Xu, Xu, Xu, Xu, Xu, Xu, Xu, Xu, Xu, Xu, Xu, Xu, Uu, Xu, Xu, Xu, Qlf^Yl, Xu, Qlf^Yl, Xu, Uu, Uu, Rr, Xu, Qlf^Yl, Xu, Xu, Xu, Xu, Xu, Xu, Xu, Xu, Xu, Xu, Xu, Xu, Xu, Xu, Xu, Xu, Xu, Xu, Xu, Xu, Xu, Xu, Xu, Xu, Xu
Xu, Xu, Xu, Xu, Xu, Xu, Xu, Xu, Xu, Xu, Xu, Xu, Xu, Xu, Uu, Xu, Qlf^Yl, Qlf^Yl, Qlf^Yl, Qlf^Yl, Uu, Qlf^Yl, Qlf^Yl, Rr, Rr, Qlf^Yl, Qlf^Yl, Qlf^Yl, Re, Xu, Xu, Xu, Xu, Xu, Xu, Xu, Xu, Xu, Xu, Xu, Xu, Xu, Xu, Xu, Xu, Xu, Xu, Xu, Xu, Xu, Xu, Xu
Xu, Xu, Xu, Xu, Xu, Xu, Xu, Xu, Xu, Xu, Xu, Xu, Xu, Xu, Xu, Uu, Qlf^Yl, Qlf^Yl, Qlf^Yl, Qlf^Yl, Qlf^Yl, Qlf^Yl, Qlf^Yl, Rr, Rd, Re, Uu, Uu, Uu, Re, Re, Xu, Xu, Xu, Xu, Xu, Xu, Xu, Xu, Xu, Xu, Xu, Xu, Xu, Xu, Xu, Xu, Xu, Xu, Xu, Xu, Xu
Xu, Xu, Xu, Xu, Xu, Xu, Xu, Xu, Xu, Xu, Xu, Xu, Xu, Xu, Xu, Qlf^Yl, Qlf^Yl, Qlf^Yl, Qlf^Yl, Qlf^Yl, Qlf^Yl, Qlf^Yl, Qlf^Yl, Rd, Rd, Qlf^Yl, Qlf^Yl, Uu, Qlf^Yl, Qlf^Yl, Re, Xu, Xu, Xu, Xu, Xu, Xu, Xu, Xu, Xu, Xu, Xu, Xu, Xu, Xu, Xu, Xu, Xu, Xu, Xu, Xu, Xu
Xu, Xu, Xu, Xu, Xu, Xu, Xu, Xu, Xu, Xu, Xu, Xu, Xu, Xu, Qlf^Yl, Qlf^Yl, Qlf^Yl, Qlf^Yl, Qlf^Yl, Qlf^Yl, Qlf^Yl, Qlf^Yl, Rd, Rd, Rd, Qlf^Yl, Uu, Qlf^Yl, Qlf^Yl, Qlf^Yl, Re, Xu, Xu, Xu, Xu, Xu, Xu, Xu, Xu, Xu, Xu, Xu, Xu, Xu, Xu, Xu, Xu, Xu, Xu, Xu, Xu, Xu
Xu, Xu, Xu, Xu, Xu, Xu, Xu, Xu, Xu, Xu, Xu, Xu, Qlf^Yl, Qlf^Yl, Qlf^Yl, Qlf^Yl, Qlf^Yl, Qlf^Yl, Uu, Qlf^Yl, Rd, Rd, Rd, Rd, Qlf^Yl, Qlf^Yl, Qlf^Yl, Qlf^Yl, Qlf^Yl, Qlf^Yl, Qlf^Yl, Qlf^Yl, Xu, Xu, Xu, Xu, Xu, Xu, Xu, Xu, Xu, Xu, Xu, Xu, Xu, Xu, Xu, Xu, Xu, Xu, Xu, Xu
Xu, Xu, Xu, Xu, Xu, Xu, Xu, Xu, Xu, Xu, Uu, Uu, Qlf^Yl, Qlf^Yl, Qlf^Yl, Qlf^Yl, Qlf^Yl, Uu, Qlf^Yl, Qlf^Yl, Rr, Rr, Qlf^Yl, Qlf^Yl, Qlf^Yl, Qlf^Yl, Qlf^Yl, Qlf^Yl, Uu, Uu, Re, Re, Xu, Xu, Xu, Xu, Xu, Xu, Xu, Xu, Xu, Xu, Xu, Xu, Xu, Xu, Xu, Xu, Xu, Xu, Xu, Xu
Xu, Xu, Xu, Xu, Xu, Xu, Xu, Xu, Uu, Uu, Xu, Uu, Qlf^Yl, Qlf^Yl, Qlf^Yl, Qlf^Yl, Qlf^Yl, Uu, Rd, Rd, Rd, Uu, Uu, Qlf^Yl, Qlf^Yl, Qlf^Yl, Qlf^Yl, Qlf^Yl, Qlf^Yl, Uu, Xu, Xu, Xu, Xu, Xu, Xu, Xu, Xu, Xu, Xu, Xu, Xu, Xu, Xu, Xu, Xu, Xu, Xu, Xu, Xu, Xu, Xu
Xu, Xu, Xu, Xu, Xu, Xu, Xu, Xu, Uu, Xu, Xu, Xu, Xu, Qlf^Yl, Qlf^Yl, Qlf^Yl, Rd, Rr, Rd, Rd, Qlf^Yl, Qlf^Yl, Qlf^Yl, Re, Qlf^Yl, Qlf^Yl, Qlf^Yl, Qlf^Yl, Qlf^Yl, Qlf^Yl, Re, Xu, Xu, Xu, Xu, Xu, Xu, Xu, Xu, Xu, Xu, Xu, Xu, Uu^Vu, Uu, Uu, Uu, Xu, Xu, Xu, Xu, Xu
Xu, Xu, Xu, Xu, Xu, Xu, Xu, Xu, Uu, Xu, Xu, Xu, Xu, Xu, Qlf^Yl, Qlf^Yl, Rr, Rr, Qlf^Yl, Qlf^Yl, Qlf^Yl, Qlf^Yl, Qlf^Yl, Qlf^Yl, Qlf^Yl, Qlf^Yl, Qlf^Yl, Qlf^Yl, Qlf^Yl, Uu, Qlf^Yl, Re, Re, Xu, Xu, Xu, Xu, Xu, Xu, Xu, Uu^Vu, Xu, Uu, Uu, Uu, Uu, Cud, Uu, Uu, Xu, Xu, Xu
Xu, Xu, Xu, Xu, Xu, Xu, Xu, Xu, Uu^Xo, Xu, Xu, Xu, Xu, Xu, Xu, Qlf^Yl, Uu, Rd, Qlf^Yl, Qlf^Yl, Qlf^Yl, Qlf^Yl, Qlf^Yl, Uu, Uu, Qlf^Yl, Qlf^Yl, Qlf^Yl, Uu, Qlf^Yl, Qlf^Yl, Qlf^Yl, Re, Xu, Xu, Xu, Xu, Xu, Xu, Uu, Uu, Xu, Re, Uh, Uu, Cud, 8 Kud, Cud, Uu, Xu, Xu, Xu
Xu, Xu, Qxu, Xu, Xu, Xu, Xu, Re^Xo, Re^Xo, Re^Xo, Xu, Xu, Xu, Xu, Xu, Uu, Uu, Uu, Uu, Qlf^Yl, Qlf^Yl, Qlf^Yl, Qlf^Yl, Re, Qlf^Yl, Qlf^Yl, Qlf^Yl, Qlf^Yl, Qlf^Yl, Qlf^Yl, Uu, Qlf^Yl, Re, Xu, Xu, Xu, Uu, Uu, Xu, Uu, Uu, Xu, Re, Uu, Uu, Cud, Cud, Cud, Uu, Uu^Em, Xu, Xu
Xu, Xu, Qxu, Xu, Xu, Xu, Uu, Re, Uu, Uu, Uu, Xu, Xu, Xu, Xu, Uh, Uu, Uu, Uu, Qlf^Yl, Xu, Qlf^Yl, Qlf^Yl, Qlf^Yl, Qlf^Yl, Uu, Qlf^Yl, Qlf^Yl, Qlf^Yl, Qlf^Yl, Uu, Re, Xu, Xu, Uu, Xu, Uu, Re, Xu, Uu, Uu, Xu, Uu, Uu, Uu, Uu^Em, Uu, Uu, Uh, Uu, Xu, Xu
Xu, Xu, Qxu, Xu, Xu, Uu, Uu, Uu, Uu, Uu^Vu, Uh, Xu, Xu, Xu, Xu, Uu, Uu, Xu, Xu, Xu, Xu, Xu, Xu, Xu, Re, Qlf^Yl, Qlf^Yl, Uu, Uu, Qlf^Yl, Xu, Xu, Xu, Uu, Uu, Xu, Uu, Re, Uu, Uu, Uu, Uu, Uu^Em, Uu, Uu, Uu, Uu, Uu, Uu^Em, Uu, Xu, Xu
Xu, Xu, Xu, Qxu, Qxu, Uu, Uu, Uu, Xu, Uh, Xu, Xu, Xu, Xu, Xu, Uu, Uu, Uu, Xu, Xu, Xu, Xu, Wwg, Re, Re, Re, Re, Uu, Xu, Xu, Xu, Xu, Uu, Uu, Uu, Uu, Uu, Uu, Uu, Uu, Re, Re, Xu, Tb^Tf, Tb^Tf, Uu^Vu, Tb^Tf, Uu, Xu, Xu, Xu, Xu
Xu, Xu, Xu, Xu, Uu, Qxu, Qxu, Xu, Xu, Xu, Xu, Xu, Xu, Xu, Xu, Re, Uu, Uu, Uh, Xu, Xu, Xu, Xu, Xu, Xu, Xu, Xu, Xu, Xu, Xu, Uu, Uu, Xu, Re, Uu, Uu, Uu, Uu, Xu, Uu, Re, Xu, Xu, Xu, Wwg, Wwg, Wwg, Tb^Tf, Xu, Xu, Xu, Xu
Xu, Xu, Xu, Uu, Xu, Xu, Xu, Qxu, Qxu, Xu, Xu, Xu, Xu, Xu, Xu, Re, Re, Uu, Uu, Uu, Uu, Uu, Re, Re, Re, Re, Uu, Re, Re, Re, Xu, Xu, Xu, Re, Uu, Xu, Uu^Em, Uu, Xu, Uu, Uu, Xu, Xu, Xu, Xu, Wwg, Wwg, Xu, Xu, Xu, Xu, Xu
Xu, Xu, Xu, Xu, Xu, Xu, Xu, Xu, Xu, Xu, Xu, Xu, Xu, Xu, Xu, Xu, Xu, Re, Xu, Re, Re, Re, Xu, Uu, Xu, Uu, Xu, Uu, Xu, Xu, Xu, Xu, Xu, Xu, Xu, Xu, Xu, Uu, Xu, Uu^Vu, Xu, Xu, Xu, Xu, Xu, Xu, Xu, Xu, Xu, Xu, Xu, Xu
Xu, Xu, Xu, Xu, Xu, Xu, Xu, Xu, Xu, Xu, Xu, Xu, Xu, Xu, Xu, Xu, Xu, Xu, Xu, Xu, Xu, Xu, Xu, Xu, Xu, Xu, Xu, Xu, Xu, Xu, Xu, Xu, Xu, Xu, Xu, Xu, Xu, Xu, Xu, Xu, Xu, Xu, Xu, Xu, Xu, Xu, Xu, Xu, Xu, Xu, Xu, Xu
Xu, Xu, Xu, Xu, Xu, Xu, Xu, Xu, Xu, Xu, Xu, Xu, Xu, Xu, Xu, Xu, Xu, Xu, Xu, Xu, Xu, Xu, Xu, Xu, Xu, Xu, Xu, Xu, Xu, Xu, Xu, Xu, Xu, Xu, Xu, Xu, Xu, Xu, Xu, Xu, Xu, Xu, Xu, Xu, Xu, Xu, Xu, Xu, Xu, Xu, Xu, Xu
