Wo, Wo, Wo, Wo, Wo, Wo, Wo, Wo, Wo, Wo, Wo, Wo, Wo, Wo, Wo, Wo, Wo, Wo, Wo, Wo, Wo, Wo, Wo, Wo, Wo, Wo, Wo, Wo, Wo, Wo, Wo, Wo, Wo, Wo, Wo, Wo, Wo, Wo, Wo, Wo, Wo, Wo, Wo, Wo, Wo, Wo, Wo, Wo, Wo, Wo, Wo, Wo, Wo, Wo, Wo, Wo, Wo, Wo, Wo, Wo, Wo, Wo, Wo
Wo, Wo, Wo, Wo, Wo, Wo, Wo, Wo, Wo, Wo, Wo, Wo, Wo, Wo, Wo, Wo, Wo, Wo, Wo, Wo, Wo, Wo, Wo, Wo, Wo, Wo, Wo, Wo, Wo, Wo, Wo, Wo, Wo, Wo, Wo, Wo, Wo, Wo, Wo, Wo, Wo, Wo, Wo, Wo, Wo, Wo, Wo, Wo, Wo, Wo, Wo, Wo, Wo, Wo, Wo, Wo, Wo, Wo, Wo, 8 Wo, Wo, Wo, Wo
Wo, Wo, Wo, Wo, Wo, Wo, Wo, Wo, Wo, Wo, Wo, Wo, Wo, Wo, Wo, Wo, Wo, Wo, Wo, Wo, Wo, Wo, Wo, Wo, Wo, Wo, Wo, Wo, Wo, Wo, Wo, Wo, Wo, Wo, Wo, Wo, Wo, Wo, Wo, Wo, Wo, Wo, Wo, Wo, Wo, Wo, Wo, Wo, Wo, Wo, Wo, Wo, Wo, Wo, Wo, Wo, Wo, Wo, Wo, Wo, Wo, Wo, Wo
Wo, Wo, Wo, Wo, Wo, Wo, Wo, Wo, Wo, Wo, Wo, Wo, Wo, Wo, Wo, Wo, Wo, Wo, Wo, Wo, Wo, Wo, Wo, Wo, Wo, Wo, Wo, Wo, Wo, Wo, Wo, Wo, Wo, Wo, Wo, Wo, Wo, Wo, Wo, Wo, Wo, Wo, Wo, Wo, Wo, Wo, Wo, Wo, Wo, Wo, Wo, Wo, Wo, Wo, Wo, Wo, Wo, Wo, Wo, Wo, Wo, Wo, Wo
Wo, Wo, Wo, Wo, Wo, Wo, Wo, Wo, Mm^Xm, Wo, Wo, Wo, Wo, Wo, Wo, Wo, Wo, Wo, Wo, Wo, Wo, Wo, Wo, Wo, Wo, Wo, Wo, Wo, Wo, Wo, Wo, Wo, Wo, Wo, Wo, Wo, Wo, Wo, Wo, Wo, Wo, Wo, Wo, Wo, Wo, Wo, Wo, Wo, Wo, Wo, Wo, Wo, Wo, Wo, Wo, Wo, Wo, Wo, Wo, Wo, Wo, Wo, Wo
Wo, Wo, Wo, Wo, Wo, Wo, Wo, Mm^Xm, Wo, Wo, Wo, Wo, Mm^Xm, Wo, Wo, Wo, Wo, Wo, Wo, Wo, Wo, Wo, Wo, Wo, Wo, Wo, Wo, Wo, Wo, Wo, Wo, Wo, Wo, Wo, Wo, Wo, Wo, Wo, Wo, Wo, Wo, Wo, Wo, Wo, Wo, Wo, Wo, Wo, Wo, Wo, Wo, Wo, Wo, Wo, Wo, Wo, Wo, Wo, Wo, Wo, Wo, Wo, Wo
Wo, Wo, Wo, Wo, Wo, Wo, Wo, Wo, Xu, Wo, Wo, Wo, Wo, Wo, Wo, Wo, Wo, Wo, Wo, Wo, Wo, Wo, Wo, Wo, Wo, Wo, Wo, Wo, Wo, Wo, Wo, Wo, Wo, Wo, Wo, Wo, Wo, Wo, Wo, Wo, Wo, Wo, Wo, Wo, Wo, Wo, Wo, Wo, Wo, Wo, Wo, Wo, Wo, Wo, Wo, Wo, Wo, Wo, Wo, Wo, Wo, Wo, Wo
Wo, Wo, Wo, Mm^Xm, Wo, Wo, Xu, Xu, Xu, Xu, Xu, Xu, Xu, Mm, Mm, Mm, Mm, Wo, Wo, Wo, Wo, Wo, Wo, Wo, Wo, Wo, Wo, Wo, Wo, Wo, Wo, Wo, Wo, Wo, Wo, Wo, Wo, Wo, Wo, Wo, Wo, Wo, Wo, Wo, Wo, Wo, Wo, Wo, Wo, Wo, Wo, Wo, Wo, Wo, Wo, Wo, Wo, Wo, Wo, Wo, Wo, Wo, Wo
Wo, Wo, Wo, Wo, Wo, Wo, Xu, Xu, Cud, Cud, Cud, Mm, Mm, Mm, Gs^Ft, Hh, Hh, Mm, Mm, Wo, Wo, Wo, Wo, Wo, Wo, Wo, Wo, Wo, Wo, Wo, Wo, Wo, Wo, Wo, Wo, Wo, Wo, Wo, Wo, Wo, Wo, Wo, Wo, Wo, Wwt, Wo, Wo, Wo, Wo, Wo, Wo, Wo, Wo, Wo, Wo, Wo, Wo, Wo, Wo, Wo, Wo, Wo, Wo
Wo, Wo, Mm^Xm, Wo, Wo, Xu, Xu, Cud, Cud, 5 Kud, Cud, Cud, Gs, Gs^Ft, Gs, Gs^Vht, Mm, Mm, Mm, Wo, Wo, Wo, Wo, Wo, Wo, Wo, Wo, Wo, Wo, Wo, Wo, Wo, Wo, Wo, Wo, Wo, Wo, Wo, Wo, Wo, Wo, Wo, Wwt, Wwt, Ds, Wwt, Wwt, Wwt, Wwt, Wo, Wo, Wo, Wwt, Wo, Wwt, Wwt, Wwt, Wwt, Wwt, Wo, Wo, Wo, Wo
Wo, Wo, Wo, Wo, Wo, Wo, Mm, Xu, Gs, Cud, Gs, Gs, Ww^Wyc, Gs, Gs, Hh, Hh, Mm, Mm, Mm, Wo, Wo, Wo, Wo, Wo, Wo, Wo, Wo, Wo, Wo, Wo, Wo, Wo, Wo, Wo, Wo, Wo, Wo, Wo, Wo, Wwt, Wwt, Ds, Dd^Ftp, Rd^Ftp, Ds, Dd^Ftp, Ds, Ds, Wwt, Wwt, Wwt, Wwt, Wwt, Wwt, Ds, Ds, Ds, Ds, Wwt, Wwt, Wo, Wo
Wo, Wo, Wo, Wo, Wo, Mm, Hh, Hh, Gs, Gs, Ww^Bw|, Ss, Ww, Ww^Bw/, Gs, Hh, Ss, Ss, Mm, Wo, Wo, Wo, Wo, Wo, Wo, Wo, Wo, Wo, Wo, Wo, Wo, Wo, Wo, Wo, Wo, Wo, Wo, Wo, Wo, Wo, Wwt, Ds, Rd^Ftp, Rd^Ftp, Gs^Ft, Rd^Ftp, Gs^Ft, Rd^Ftp, Gs^Ftp, Ds, Wwt, Wwt, Wwt, Wwt, Wwt, Gs^Ftp, Gs^Ftp, Gs^Ftp, Gs^Ftp, Ds, Wwt, Wo, Wo
Wo, Wo, Wo, Wo, Wo, Mm, Mm, Gg^Vh, Gs, Ww^Wyc, Ww, Ww, Ww, Ww, Ww, Ww^Bw\, Gs, Ss, Mm, Mm, Wo, Wo, Wo, Wo, Wo, Wo, Wo, Wo, Mm^Xm, Wo, Wo, Wo, Wo, Wo, Wo, Wo, Wo, Wo, Wo, Wwt, Ds, Dd^Ftp, Gs^Ft, Gs^Ft, Hh, Gs^Ft, Gs^Ft, Hh, Gs^Ftp, Ds, Ds, Wwt, Wwt, Wwt, Gs^Ft, Gs^Ftp, Gs, Gs^Ft, Gs^Ftp, Ds, Ds, Wwt, Wwt
Wo, Wo, Wo, Wo, Mm^Xm, Mm^Xm, Ss, Mm, Gs, Gs, Ss, Ww, Mm^Xm, Ww, Ww, Ss, Gs, Ch, Re, Mm, Mm, Wo, Wo, Mm^Xm, Mm^Xm, Wo, Wo, Mm^Xm, Wo, Wo, Wo, Mm^Xm, Wo, Wo, Wo, Wo, Wo, Wo, Wo, Wwt, Ds, Rd^Ftp, Gs^Ft, Hh, Hh, Hh, Gs^Ft, Gs, Hh, Gs^Ftp, Gs^Ftp, Wwt, Wwt, Gs^Ft, Gs^Ft, Gs^Ft, Gs^Ft, Gs, Gs^Ft, Ds, Ds, Wwt, Wwt
Wo, Wo, Wo, Wo, Wo, Mm^Xm, Mm^Xm, Ss, Ss, Ww^Bw|, Ss, Ww, Mm^Xm, Mm^Xm, Ww, Ww^Wyc, Ds, Re, Gg^Vh, Mm, Mm, Wo, Wo, Mm^Xm, Wo, Wo, Wo, Wo, Wo, Wo, Wo, Wo, Wo, Wo, Wo, Wo, Wo, Wo, Wo, Wwt, Dd^Ftp, Rd^Ftp, Gs^Ft, Gs, Gs^Ft, Gs^Ft, Gs^Ft, Gs^Ft, Hh, Hh, Gs^Ft, Wwt, Wwt, Wwt, Wwt, Gs^Ft, Gs^Ft, Gs^Ft, Gs^Ft, Gs^Ftp, Ds, Wwt, Wwt
Wo, Wo, Wo, Wo, Wo, Wo, Mm, Mm, Gs^Ft, Gs^Ft, Ww^Wyc, Ww, Ww, Mm^Xm, Ww, Ww^Bw/, Ds, Hh, Mm, Mm, Mm, Wo, Wo, Wo, Wo, Wo, Wo, Wo, Xu, Wo, Xu, Wo, Wo, Mm^Xm, Wo, Wo, Wo, Wo, Wo, Wwt, Gs, Gs^Ftp, Gs^Ft, Gs^Ft, Gs^Ft, Gs^Ft, Hh, Gs^Ft, Gs^Ft, Gs^Ft, Gs, Gs, Gs, Gs, Gs, Wwt, Gs^Ft, Gs^Ft, Gs^Ft, Gs^Ftp, Ds, Wwt, Wwt
Wo, Wo, Wo, Wo, Wo, Wo, Mm, Hh, Hh, Gs^Ft, Gs, Ww^Bw/, Ww, Ww, Ww, Ww, Mm^Xm, Mm, Wo, Wo, Wo, Wo, Wo, Wo, Mm^Xm, Wo, Wo, Xu, Xu, Xu, Xu, Wo, Wo, Wo, Wo, Wo, Wo, Wo, Wo, Wwt, Ds, Gs, Gs^Ft, Gs^Ft, Gs^Ft, Hh, Gs^Vht, Gs^Ft, Gs, Gs, Ce, Gs, Gs, Gs, Wwt, Wwt, Gs^Ft, Gs^Ft, Gs^Ft, Gs^Ftp, Ds, Wwt, Wwt
Wo, Wo, Wo, Wo, Wo, Wo, Wo, Mm, Mm, Gs^Vht, Gs^Ftp, Ww, Ds, Ww, Mm^Xm, Mm^Xm, Mm, Mm, Wo, Wo, Wo, Wo, Wo, Wo, Wo, Wo, Xu, Xu, Uu, Xu, Uu, Xu, Xu, Wo, Wo, Wo, Wo, Wo, Wo, Wwt, Wwt, Ds, Gs^Ftp, Gs^Ft, Gs^Ft, Gs^Ft, Gs^Ft, Gs^Ft, Gs, Ce, 4 Ke, Ce, Wwt, Gs, Wwt, Gs^Ft, Gs^Ft, Gs, Gs^Ftp, Gs^Ftp, Wwt, Wwt, Wwt
Wo, Wo, Wo, Wo, Wo, Wo, Wo, Mm, Mm^Xm, Gs^Ft, Gs^Ft, Ch, Re, Mm, Wo, Wo, Wo, Wo, Wo, Mm^Xm, Wo, Wo, Mm^Xm, Wo, Wo, Wo, Xu, Uu, Uu, Uu, Ww, Uu, Ww, Wo, Wo, Wo, Wo, Wo, Wo, Wo, Wwt, Ds, Ds, Gs^Ftp, Gs^Ftp, Gs^Ft, Gs, Gs^Ft, Gs, Ce, Ce, Ce, Gs^Ft, Wwt, Gs^Ft, Gs^Ft, Gs^Ftp, Gs^Ftp, Ds, Ds, Wwt, Wo, Wo
Wo, Wo, Wo, Wo, Wo, Wo, Wo, Wo, Mm^Xm, Mm^Xm, Mm, Mm, Mm, Mm, Wo, Wo, Wo, Wo, Wo, Mm^Xm, Wo, Wo, Wo, Mm^Xm, Wo, Wo, Xu, Uu, Uu, Ww, Uu, Ww, Ww, Wo, Wo, Mm^Xm, Mm^Xm, Wo, Wo, Wo, Wo, Wwt, Ds, Ds, Gs^Ftp, Gs^Ft, Gs^Ft, Gs^Ft, Gs^Ft, Gs^Ft, Gs, Gs, Gs^Ft, Gs^Ft, Gs^Ft, Gs^Ftp, Ds, Gs^Ftp, Ds, Ds, Wwt, Wo, Wo
Wo, Wo, Wo, Wo, Wo, Mm^Xm, Wo, Wo, Wo, Mm^Xm, Wo, Mm, Wo, Wo, Wo, Wo, Mm^Xm, Wo, Wo, Wo, Wo, Wo, Wo, Wo, Wo, Wo, Wo, Xu, Xu, Uu, Xu, Xu, Wo, Wo, Wo, Wo, Wo, Wo, Wo, Wo, Wo, Wwt, Ds, Ds, Ds, Gs^Ft, Gs^Ft, Gs^Vht, Gs^Ft, Gs^Ft, Gs^Ft, Gs^Ft, Gs^Ft, Gs, Gs^Ftp, Gs^Ftp, Ds, Ds, Ds, Wwt, Wo, Wo, Wo
Wo, Wo, Wo, Wo, Wo, Wo, Wo, Wo, Wo, Wo, Wo, Wo, Wo, Mm^Xm, Wo, Wo, Wo, Wo, Wo, Wo, Wo, Wo, Gs, Wo, Wo, Wo, Wo, Wo, Wo, Xu, Xu, Wo, Wo, Wo, Wo, Wo, Mm^Xm, Wo, Wo, Wo, Wo, Wwt, Ds, Ds, Ds, Gs^Ftp, Gs^Ftp, Gs^Ft, Gs, Gs^Ft, Gs^Ft, Gs^Ft, Gs^Vht, Gs^Ft, Gs^Ftp, Ds, Wwt, Ds, Ds, Wwt, Wo, Wo, Wo
Wo, Wo, Wo, Wo, Wo, Wo, Mm^Xm, Wo, Wo, Mm^Xm, Wo, Wo, Wo, Wo, Wo, Wo, Wo, Wo, Wo, Wo, Gs, Gs^Ftp, Gs, Gs, Wo, Wo, Wo, Wo, Wo, Xu, Wo, Wo, Wo, Mm^Xm, Wo, Wo, Wo, Wo, Wo, Wo, Wo, Wwt, Wwt, Ds, Ds, Ds, Ds, Ds, Gs^Ftp, Gs^Ft, Gs^Ftp, Gs^Ftp, Gs^Ftp, Gs^Ft, Gs^Ftp, Ds, Wwt, Wwt, Wwt, Wwt, Wo, Wo, Wo
Wo, Wo, Wo, Wo, Wo, Wo, Wo, Mm^Xm, Wo, Wo, Wo, Mm^Xm, Wo, Wo, Wo, Mm^Xm, Mm^Xm, Wo, Wo, Gs, Gg^Vh, Gs, 3 Kh, Gs, Gs, Gs^Ftp, Gs^Ftp, Wo, Wo, Wo, Wwt, Wwt, Wwt, Wo, Wwt, Wo, Wo, Wo, Wo, Wo, Wo, Wo, Wwt, Ds, Ds, Ds, Ds, Ds, Ds, Gs^Ftp, Ds, Ds, Ds, Gs^Ftp, Ds, Wwt, Wo, Wo, Wo, Wwt, Wo, Wo, Wo
Wo, Wo, Wo, Wo, Wo, Wo, Wo, Wo, Wo, Wo, Wo, Wo, Wo, Wo, Wo, Mm^Xm, Wo, Wo, Wo, Gs, Gs, Ch, Ch, Ch, Gs, Gs^Ftp, Gs, Wo, Wo, Wwt, Gs, Gs, Gs, Wwt, Ds, Wwt, Wo, Wo, Wo, Wo, Wo, Wo, Wo, Wwt, Wwt, Wwt, Wwt, Ds, Ds, Ds, Ds, Ds, Ds, Ds, Wwt, Wwt, Wo, Wo, Wo, Wo, Wo, Wo, Wo
Wo, Wo, Wo, Wo, Wo, Wo, Wo, Wo, Wo, Wo, Mm^Xm, Wo, Wo, Wo, Wo, Wo, Wo, Wo, Gs, Gs, Gs^Ftp, Gs, Gs, Gs, Wo, Wo, Wo, Wwt^Bw\, Wwt^Bw\, Wwt, Gs, Gs, Gs^Ftp, Gg^Vh, Gs, Wwt, Wwt, Wo, Wo, Wo, Mm^Xm, Wo, Wo, Wo, Wo, Wo, Wwt, Ds, Ds, Ds, Wwt, Ds, Wwt, Wwt, Wo, Wo, Wo, Wo, Wo, Wo, Wo, Wo, Wo
Wo, Wo, Wo, Wo, Wo, Wo, Wo, Wo, Wo, Wo, Wo, Wo, Wo, Mm^Xm, Wo, Wo, Wo, Wo, Wo, Wo, Wo, Wo, Gs, Gs, Wo, Wo, Wo, Wo, Wwt, Gs, Kh, Gs, Gs, Gs, Wwt, Wwt, Mm^Xm, Wo, Wo, Wo, Wo, Wo, Wo, Wo, Wo, Wo, Wo, Wwt, Wwt, Ds, Wwt, Wwt, Wo, Wo, Wo, Wo, Wo, Wo, Wo, Wo, Wo, Wo, Wo
Wo, Wo, Wo, Wo, Wo, Wo, Wo, Wo, Wo, Wo, Wo, Wo, Wo, Wo, Wo, Wo, Wo, Wo, Wo, Wo, Wo, Wo, Wwt^Bw|, Wo, Wo, Wo, Wo, Wo, Gs, Gs, Ch, Ch, Gs, Wwt, Wwt, Wwt, Mm^Xm, Mm^Xm, Wwt, Wo, Wo, Wo, Wo, Wo, Wo, Wo, Wo, Wo, Wo, Wwt, Wo, Wo, Wo, Wo, Wo, Wo, Wo, Wo, Wo, Wo, Wo, Wo, Wo
Wo, Wo, Wo, Wo, Wo, Wo, Wo, Wo, Wo, Wo, Wo, Wo, Wo, Wo, Wo, Wo, Wo, Wo, Wo, Wo, Wo, Wo, Wwt^Bw|, Wo, Wwt, Wo, Wwt, Wwt, Wwt, Gs^Ftp, Gs^Ftp, Gs, Wwt, Wwt, Wwt, Wwt, Wwt, Wwt, Wwt, Wwt, Wwt, Wo, Wo, Wo, Wo, Wo, Wo, Wo, Wo, Wo, Wo, Wo, Wo, Wo, Wo, Wo, Wo, Wo, Wo, Wo, Wo, Wo, Wo
Wo, Wo, Wo, Wo, Wo, Wo, Wo, Wo, Wo, Wo, Wo, Wo, Wo, Wo, Wo, Wo, Wo, Wo, Wwt, Wwt, Wwt, Wwt, Gs, Wwt, Ch, Gs, Gs, Wwt, Wwt, Wwt, Wwt, Wwt, Wwt, Wwt, Gs, Wwt, Ds, Wwt, Ww^Bw/, Ds, Ds, Wwt, Wwt, Wo, Wo, Wo, Wo, Wo, Wo, Wo, Wo, Wo, Wo, Wo, Wo, Wo, Wo, Wo, Wo, Wo, Wo, Wo, Wo
Wo, Wo, Wo, Wo, Wo, Wo, Wo, Wo, Wo, Wo, Wo, Wo, Wo, Wo, Wo, Wo, Wo, Wo, Wwt, Gs, Wwt, Wwt, Wwt, Gs, Ch, Ch, Gs, Wwt, Wwt, Wwt, Wwt, Wwt, Gs, Gs, Gs, Gs^Ftp, Ds, Ds, Wwt, Wwt, Wwt, Ds, Ds, Wwt, Wo, Wo, Wo, Wo, Wo, Wo, Wo, Wo, Wo, Wo, Wo, Wo, Wo, Wo, Wo, Wo, Wo, Wo, Wo
Wo, Wo, Wo, Wo, Wo, Wo, Wo, Wo, Wo, Wo, Wo, Wo, Wo, Wo, Wo, Wo, Wwt, Wwt, Gs, Gs, Gs, Wwt, Wwt, Gs, Wwt, Gs, Gs, Wwt, Wwt, Ds, Wwt, Wwt, Gg^Vh, Gs, Gs, Gs, Wwt, Wwt, Wwt, Wwt, Wwt, Gs^Ftp, Ds, Wwt, Wwt, Wo, Wo, Wo, Wo, Wo, Wo, Wo, Wwt, Wwt, Wwt, Wo, Wo, Wo, Wo, Wo, Wo, Wo, Wo
Wo, Wo, Wo, Wo, Wo, Wo, Wo, Wo, Wo, Wo, Wwrt, Wo, Wo, Wo, Wo, Wo, Wwt, Gg^Vh, Gs, Gs, Wwt, Wwt, Wwt, Wwt, Wwt, Wwt, Wwt, Wwt, Wwt, Wwt, Wwt, Wwt, Wwt, Gs, Gs, Gs, Gs, Wwt, Wwt, Gs^Ftp, Wwt, Gs^Ftp, Ds, Wwt, Wwt, Wwrt, Wwrt, Wo, Wo, Wo, Wwt, Wwt, Wwt, Ds, Ds, Wwt, Wwt, Wo, Wo, Wo, Wo, Wo, Wo
Wo, Wo, Wo, Wo, Wo, Wo, Wo, Wo, Ds, Wwrt, Wwt, Ds, Ds, Wo, Wwt, Wo, Wwt, Gs, Ch, Gs, Gs, Wwt, Wwt, Wwt, Ss, Wwt, Ss, Ds, Wwt, Wwt, Ds, Wwt, Wwt, Gs^Ftp, Gs, Ch, Gs, Wwt, Wwt, Wwt, Gs^Ftp, Gs^Ftp, Gs^Ftp, Ds, Dd^Ftd, Wwt, Wwt, Wo, Wwt, Wo, Wwt, Ds, Ds, Ds, Ss, Ds, Wwt, Wo, Wo, Wo, Wo, Wo, Wo
Wo, Wo, Wo, Wo, Wo, Wo, Wwrt, Ds, Wwt, Wwt, Wo, Wwt, Wwt, Wwrt, Wwrt, Wwt, Ds, 7 Kh, Ch, Gs, Gs, Wwt, Wwt, Ss, Gg^Vh, Gs, Gs^Ftp, Ss, Ss, Wwt, Ds, Ds, Wwt, Wwt, Wwt, Gs, Wwt, Wwt, Gs, Wwt, Gs^Ftp, Gs^Ft, Gs^Vht, Gs^Ftp, Dd^Ftp, Wwt, Ds, Wwt, Ds, Wwt, Ds, Ds, Rd^Ftp, Ds, Ss, Wwt, Wwt, Wo, Wwt, Wo, Wwt, Wo, Wo
Wo, Wo, Wo, Wo, Wo, Wwt, Wo, Wo, Wo, Wo, Wo, Wo, Wo, Wwt, Wwt, Ds, Ds, Ds, Ds, Ds, Ds, Wwt, Ss, Ss, Gs, Gs, Gs, Gs, Ss, Ss, Wwt, Wwt, Wwt, Wwt, Wwt, Wwt, Wwt, Ch, Gs, Wwt, Gs^Ftp, Gs^Ft, Gs^Ft, Gs^Ft, Gs^Ftp, Ds, Gs^Ftp, Ds, Rd^Ftp, Ds^Edp, Rd^Ftp, Rd^Ftp, Rd^Ftp, Ds, Ss, Wwt, Wwt, Wwt, Ss, Wwt, Ds, Wwt, Wwt
Wo, Wo, Wo, Wo, Wo, Ds, Wo, Wo, Wo, Wo, Wo, Wo, Wo, Wo, Wo, Wwt, Wwt, Wwt, Ss, Ss, Ss, Ww^Bw\, Ww^Bw\, Ss, Gs, Gs, Gs^Ft, Ss, Ss, Ss, Ss, Wwt, Wwt, Wwt, Wwt, Gs, Wwt, Wwt, Wwt, Wwt, Gs^Ftp, Gs^Ft, Gs^Ft, Gs^Ft, Gs^Ft, Gs^Ftp, Gs^Ft, Gs^Ftp, Gs^Ft, Rd^Ftp, Gs, Rd^Ft, Rd^Ftp, Ds, Ds, Ss, Ss, Ss, Ds, Ds, Gs^Ftp, Ds, Ds
Wo, Wo, Wo, Wo, Wo, Wwrt, Wwrt, Wo, Wo, Wo, Wo, Wo, Wo, Wo, Wo, Wo, Wwt, Wwt, Wwt, Wwt, Wwt, Ss, Ss, Gs, Gs^Ft, Gs, Gs^Ft, Gs^Ft, Ss, Ss, Ww^Bw/, Gs^Ftp, Gs^Ftp, Gs, Gs^Ftp, Wwt, Wwt, Wwt, Wwt, Wwt, Wwt, Gs^Ft, Gs^Ft, Gs^Ft, Gs^Vht, Gs^Ft, Gs^Ft, Gs^Ft, Gs^Ft, Gs^Ft, Gs^Ft, Gs^Ft, Gs^Ft, Rd^Ftp, Rd^Ftp, Ds, Ds, Ds, Rd^Ftp, Rd^Ftp, Gs^Ft, Rd^Ftp, Rd^Ftp
Wo, Wo, Wo, Wo, Wo, Wwt, Ds, Wo, Wo, Wo, Wo, Wo, Wo, Wo, Wo, Wo, Wwt, Wwt, Wwt, Wwt, Wwt, Ss, Ss, Ss, Ss, Gs^Ft, Ch, Ss, Ww^Bw/, Gs^Ftp, Ss, Ss, Gs^Ftp, Gs^Ftp, Gs^Ft, Gs^Ftp, Gs, Gs^Ftp, Gs^Vht, Wwt, Gs^Ft, Gs^Ft, Gs, Gs^Ft, Gs^Ft, Gs^Ft, Gs, Gs^Ft, Gs^Ft, Gs^Ft, Gs^Ft, Gs^Ft, Gs^Ft, Gs^Ft, Gs^Ft, Rd^Ftp, Rd^Ftp, Rd^Ftp, Gs^Ft, Gs^Ft, Gs^Ft, Rd^Ft, Rd^Ft
Wo, Wo, Wo, Wo, Wo, Wo, Wo, Wo, Wo, Wo, Wo, Wo, Wo, Wo, Wo, Wo, Wwt, Ds, Ds, Wwt, Wwt, Wwt, Ss, Ss, Ss, Gs^Ft, Gs^Ft, Gs^Ft, Ss, Ss, Ss, Ss, Ss, Gs^Vht, Gs^Ft, Gs^Ft, Gs^Ft, Gs^Ft, Gs^Ft, Gs^Ft, Gs^Ft, Gs^Ft, Gs^Ft, Gs^Ft, Gs^Ft, Gs^Ft, Gs, Gs^Ft, Gs^Ft, Gs^Ft, Gs^Ft, Gs^Ft, Gs^Ft, Gs^Ft, Gs^Ft, Gs^Ft, Gs^Ft, Gs^Ft, Gs, Gs, Gs, Gs^Ft, Gs^Ft
Wo, Wo, Wo, Wo, Wo, Wo, Wo, Wo, Wo, Wo, Wo, Wo, Wo, Wo, Wo, Wo, Wo, Wwt, Wwt, Wwt, Wwt, Ss, Ds, Ss, Ss, Ss, Ss, Ww^Bw\, Gs^Ft, Ss, Ss, Ss, Ss, Gs^Ft, Gs^Ft, Gs^Ft, Gs^Ft, Gs^Ft, Gs^Ft, Gs^Ft, Rd^Ft, Rd^Ft, Rd^Ftp, Gs^Ft, Rd^Ft, Gs, Gs^Ft, Gs^Ft, Rd^Ft, Gs^Ft, Rd^Ft, Gs, Gs^Ft, Gs^Ft, Gs^Ft, Gs^Ft, Gs^Ft, Gs, Gs, Gs, Gs, Gs^Ft, Gs^Ft
Wo, Wo, Wo, Wo, Wo, Wo, Wo, Wo, Wo, Wo, Wo, Wo, Wo, Wo, Wo, Wo, Wo, Wwt, Wwt, Wwt, Wwt, Ds, Ds, Ds, Ds, Ds, Ds, Ss, Ww^Bw|, Ss, Ss, Ss, Ss, Gs^Ft, Gs^Ft, Gs^Ft, Gs^Ft, Gs^Ft, Gs^Ft, Rd, Rd^Ftp, Rd^Ftp, Dd, Rd^Ftp, Rd^Ftp, Rd^Ft, Rd^Ft, Rd^Ft, Rd^Ftp, Rd^Ftp, Rd^Ftp, Rd^Ft, Rd^Ft, Gs^Ft, Rd^Ft, Gs^Ft, Gs^Ft, Gs, Gs, Gs, Gs^Ft, Gs^Ft, Gs^Ft
Wo, Wo, Wo, Wo, Wo, Wo, Wo, Wo, Wo, Wo, Wo, Wo, Wo, Wo, Wo, Wo, Wo, Wwt, Ds, Wwt, Wwt, Ds, Gs^Ftp, Gs^Ftp, Gs, Gs^Ftp, Gs^Ftp, Ds, Gs^Ftp, Gs^Ft, Gs^Ft, Gs, Gs^Ft, Ss, Ss, Gs^Vht, Gs^Ft, Gs^Ft, Rd^Ftp, Rd^Ftp, Dd^Ftd, Rd^Ftp, Dd, Dd^Edp, Dd, Rd^Ftp, Dd^Ftd, Rd^Ftp, Dd, Dd, Dd, Rd^Ftp, Gs^Ftp, Gs^Ftp, Rd^Ftp, Rd^Ft, Gs^Ft, Gs, Gs, Gs^Ft, Gs^Ft, Gs^Ft, Gs^Ft
Wo, Wo, Wo, Wo, Wo, Wo, Wo, Wo, Wo, Wo, Wo, Wo, Wo, Wo, Wwt, Wo, Wwt, Wwt, Wwt, Wwt, Ss, Ss, Gs^Ft, Gs^Ft, Gs^Ft, Gs^Ft, Gs^Ft, Gs^Ftp, Gs, Gs^Ft, Gs^Ft, Gs^Ft, Gs^Ft, Ss, Ss, Gs^Ft, Rd^Ft, Rd^Ftp, Dd, Dd, Dd, Dd^Edp, Dd, Dd, Dd, Dd^Edp, Dd, Dd, Dd, Dd^Edp, Dd, Dd, Dd, Dd, Dd^Ftd, Rd^Ft, Gs^Ft, Gs^Ft, Gs^Ft, Gs^Ft, Gs^Ft, Gs^Ft, Gs^Ft
Wo, Wo, Wo, Wo, Wo, Wo, Wo, Wo, Wo, Wo, Wo, Wo, Wo, Wwt, Gs^Ftp, Wwt, Wwt, Wwt, Wwt, Wwt, Ss, Ss, Ss, Gs^Ft, Gs^Ft, Gs^Ft, Gs^Ft, Gs^Ft, Gs^Ft, Gs, Gs^Ft, Gs^Ft, Gs, Gs^Ft, Rd^Ft, Gs^Ft, Rd^Ftp, Rd^Ftp, Dd, Dd, Dd, Dd, Dd, Dd, Dd, Dd, Dd, Dd, Dd, Dd, Dd, Dd, Dd, Dd, Dd, Rd^Ftp, Rd^Ft, Gs^Ft, Rd^Ft, Rd^Ft, Gs^Ft, Gs^Ft, Gs^Ft
Wo, Wo, Wo, Wo, Wo, Wo, Wo, Wo, Wo, Wo, Wwt, Wo, Wwt, Wwt, Wwt, Wwt, Wwt, Wwt, Wwt, Ss, Ss, Ss, Ss, Ss, Ss, Ss, Ss, Ss, Ss, Gs^Ft, Gs^Vht, Gs^Ft, Rd^Ft, Rd^Ft, Rd^Ftp, Rd^Ftp, Rd^Ftp, Dd^Ftd, Dd, Dd^Edp, Dd, Hd, Dd, Dd^Edp, Dd, Dd, 2 Hd, Dd, Dd, Dd^Vdt, Dd, Dd, Dd, Dd^Edp, Dd, Dd^Ftd, Dd^Ftd, Rd^Ftp, Rd^Ftp, Rd^Ft, Gs^Ft, Gs^Ft, Gs^Ft
Wo, Wo, Wo, Wo, Wo, Wo, Wwt, Wo, Wo, Wwt, Gs^Ftp, Wwt, Gs^Ftp, Wwt, Gs^Ftp, Gs^Ftp, Gs^Ftp, Gs^Ftp, Ss, Ss, Ss, Ss, Ss, Ss, Ss, Ss, Gs^Ft, Gs^Ft, Ss, Gs^Ft, Gs^Ft, Gs^Ft, Rd^Ftp, Rd^Ftp, Rd^Ftp, Rd^Ftp, Dd, Dd, Dd, Dd, Dd, Dd, Dd, Dd, Dd, 1 Hd, Hd, Dd, Dd, Dd, Hd, Dd, Dd, Dd, Dd, Dd, Dd, Dd, Dd, Rd^Ftp, Gs^Ftp, Gs^Ftp, Gs^Ftp
Wo, Wo, Wo, Wo, Wo, Wwt, Gs^Ftp, Wwt, Wwt, Wwt, Wwt, Wwt, Gs^Ftp, Gs^Ftp, Gs^Ft, Gs^Ftp, Gs^Ft, Gs^Ft, Gs^Ft, Ss, Gs^Ft, Gs^Ft, Gs^Ft, Gs^Ft, Gs^Ft, Gs^Ft, Gs^Ft, Gs^Ft, Ss, Gs^Ft, Rd^Ft, Rd^Ft, Dd^Ftd, Dd, Dd^Ftd, Rd^Ftp, Dd, Dd^Edp, Hd, Hd, Hd, Dd, Dd^Vdt, Dd, Dd, Hd, Hd, Hd, Dd, Dd, Hd, Hd, Hd, Dd, Dd, Dd, Dd, Dd, Dd, Dd, Dd, Dd, Dd
Wo, Wo, Wo, Wo, Wwt, Wwt, Wwt, Wwt, Gs^Ftp, Gs^Ftp, Gs^Ftp, Gs^Ftp, Gs^Ft, Gs, Gs^Ft, Gs^Ft, Gs^Ft, Gs^Ft, Gs^Ft, Gs^Ft, Gs^Ft, Gs^Ft, Gs^Ft, Gs^Ft, Gs^Ft, Gs^Ft, Gs^Ft, Ss, Gs^Ft, Gs, Gs^Ft, Rd^Ftp, Dd, Dd, Dd^Edp, Dd, Dd, Dd, Hd, Hd, Hd, Dd, Dd, Dd, Hd, Hd, Hd, Hd, Hd, Dd, Dd, Hd, Hd, Hd, Hd, Dd, Hd, Dd, Dd, Dd^Edp, Dd, Dd, Dd
Wo, Wo, Wo, Wo, Wwt, Wwt, Wwt, Wwt, Gs^Ftp, Gs^Ftp, Gs^Ftp, Gs^Ft, Gs^Ft, Gs, Gs^Ft, Gs^Ft, Gs^Ft, Gs^Ft, Gs^Ft, Gs^Ft, Gs^Ft, Gs^Ft, Gs^Ft, Gs^Ft, Gs^Ft, Gs^Ft, Gs^Ft, Ss, Gs^Ft, Gs, Gs^Ftp, Rd^Ftp, Dd, Dd, Dd, Dd, Dd, Dd, Hd, Hd, Hd, Dd, Dd, Dd, Hd, Hd, Hd, Hd, Hd, Dd, Dd, Hd, Hd, Hd, Hd, Dd, Hd, Dd, Dd, Dd, Dd, Dd, Dd
