Xu, Xu, Xu, Xu, Xu, Xu, Xu, Xu, Xu, Xu, Xu, Xu, Xu, Xu, Xu, Xu, Xu, Xu, Xu, Xu, Xu, Xu
Xu, Xu, Xu, Xu, Xu, Xu, Xu, Xu, Xu, Xu, Xu, Xu, Xu, Xu, Xu, Xu, Xu, Xu, Xu, Xu, Xu, Xu
Xu, Xu, Xu, Xu, Xu, Xu, Xu, Xu, Xu, Xu, Xu, Xu, Xu, Xu, Xu, Xu, Xu, Xu, Xu, Xu, Xu, Xu
Xu, Xu, Xu, Xu, Xu, Xu, Xu, Xu, Xu, Xu, Urb, Xu, Xu, Xu, Xu, Xu, Xu, Xu, Xu, Xu, Xu, Xu
Xu, Xu, Xu, Xu, Xu, Xu, Xu, Xu, Uu, Uu^Es, Urb, Uu^Em, Uu, Xu, Xu, Xu, Xu, Xu, Xu, Xu, Xu, Xu
Xu, Xu, Xu, Xu, Xu, Xu, Uh, Uu, Uu, Xu, Urb, Xu, Uh, Uh, Uu, Xu, Xu, Xu, Xu, Xu, Xu, Xu
Xu, Xu, Xu, Xu, Uu^Es, Uu, Uu, Uu, Uu, Uu^Es, Urb, Uu^Es, Uh, Uu, Uu, Uu, Uu^Es, Xu, Xu, Xu, Xu, Xu
Xu, Xu, Xu, Urb, Urb, Xu, Uh, Uu, Xu, Uh, Urb, Uu, Xu, Uu, Uu, Xu, Urb, Urb, Xu, Xu, Xu, Xu
Xu, Xu, Xu, Uu, Xu, Urb, Urb, Uu, Uu, Uu, Urb, Uu, Uu, Uu, Urb, Urb, Xu, Uu, Xu, Xu, Xu, Xu
Xu, Xu, Xu, Uu, Uh, Uu, Uu, Urb, Urb, Uu, Urb, Uu, Urb, Urb, Uu, Uu, Uu, Uu, Xu, Xu, Xu, Xu
Xu, Xu, Xu, Uu, Uu, Uh, Xu, Uu, Uu, Urb, 3 Xu, Urb, Uu, Uu, Xu, Uh, Uu, Uh, Xu, Xu, Xu, Xu
Xu, Xu, Xu, Uu^Es, Uu, Uu^Em, Uu, Uu, Urb, Urb, Urb, Urb, Urb, Uu, Uu, Uu^Es, Uu, Uh, Xu, Xu, Xu, Xu
Xu, Xu, Xu, Uu, Xu, Uh, Urb, Urb, Uu, Uu, Urb, Uu, Uu, Urb, Urb, Uu, Xu, Uu, Xu, Xu, Xu, Xu
Xu, Xu, Xu, Uu, Urb, Urb, Uu, Uu, Xu, Uu, 1 Urb, Uu, Xu, Uh, Uu, Urb, Urb, Uu, Xu, Xu, Xu, Xu
Xu, Xu, Xu, Urb, Uu, Xu, Uu^Es, Uh, Uh, Uu, Urb, Uu, Uu^Es, Uu^Es, Uu, Xu, Uu, Urb, Xu, Xu, Xu, Xu
Xu, Xu, Xu, Xu, Xu, Uu, Uu, Uu, Uu, Uu, Urb, Uu, Uu, Uu, Uh, Uu, Xu, Xu, Xu, Xu, Xu, Xu
Xu, Xu, Xu, Xu, Xu, Xu, Xu, Uh, Uu, Xu, 2 Urb, Xu, Uh, Uu, Xu, Xu, Xu, Xu, Xu, Xu, Xu, Xu
Xu, Xu, Xu, Xu, Xu, Xu, Xu, Xu, Xu, Uu, Urb, Uu, Xu, Xu, Xu, Xu, Xu, Xu, Xu, Xu, Xu, Xu
Xu, Xu, Xu, Xu, Xu, Xu, Xu, Xu, Xu, Xu, Rb^Es, Xu, Xu, Xu, Xu, Xu, Xu, Xu, Xu, Xu, Xu, Xu
Xu, Xu, Xu, Xu, Xu, Xu, Xu, Xu, Xu, Xu, Rb, Xu, Xu, Xu, Xu, Xu, Xu, Xu, Xu, Xu, Xu, Xu
Xu, Xu, Xu, Xu, Xu, Xu, Xu, Xu, Rb^Es, Rb, Rb, Rb, Rb^Es, Xu, Xu, Xu, Xu, Xu, Xu, Xu, Xu, Xu
Xu, Xu, Xu, Xu, Xu, Xu, Xu, Xu, Rb, Rb, Rb, Rb, Rb, Xu, Xu, Xu, Xu, Xu, Xu, Xu, Xu, Xu
